....???????.....
.#...#...####...
#.@###...???....
..#####.........
........##....##
####........###.
##....?..#######
#.........##....
.....???........
#....#....#....#
##.....#####....
.??.........####