....???????.....
.#...#...####...
#.@###...???..e.
..#####.........
........##....##
####........###.
##....?..#######
#e........##....
.....???........
#....#....#....#
##.....#####....
.??e......f.####