####f...........
...............e
.....#####......
e............###
.....???????....
................
############....
................
?????????..##...
...........####.
####....@.......
##?????.......e.