####............
................
.....#####......
.............###
.....???????....
................
############....
................
?????????..##...
...........####.
####....@.......
##?????.........