@???????????????
...............e
................
?...#######.....
?...??????#.....
?...??????#.....
#...############
#.............e?
#..............?
#..............?
##########....f?
?????????????###