@???????????????
................
................
?...#######.....
?...??????#.....
?...??????#.....
#...############
#..............?
#..............?
#..............?
##########.....?
?????????????###