#..............e
.#....??????????
.#e............?
..#..........@.?
...#.#.#.#.#.#.?
?..#...........?
?...#..........?
?.....#..#.....?
?.............??
?..###########?
?........e......
??????.........f