#...............
.#....??????????
.#.............?
..#..........@.?
...#.#.#.#.#.#.?
?..#...........?
?...#..........?
?.....#..#.....?
?.............??
?...###########?
?...............
??????..........