@?????#?????????
......#########?
.........#....e?
...............?
....##.#######.?
....#..........?
....#..........?
...##........##?
.##e...........?
.#.####.....###?
...............?
###....f????????