..f?????.......e
........#...???.
..#####.#.......
......#.#####...
......#..?.....e
#######.??.#####
####....?.......
#.......?.......
#......?...#####
#####..?@....???
e............???
e???..##########